ソルジャー = Soldier
下級ソルジャー = Junior Soldier
ソルジャーチーフ = Soldier Chief
ソルジャーエリート = Soldier Elite
コマンダー = Commander
ウォリアー = Warrior
ヘビーアーマー = Heavy Armor
下級ヘビーアーマー = Junior Heavy Armor
バトルマスター = Battle Master
ギガントアーマー = Gigant Armor
アーマーガーディアン = Armor Guardian
ギガントハンマー = Gigant Hammer
ワルキューレ = Valkyrie
ユニコーンナイト = Unicorn Knight
ブリュンヒルデ = Brunhild
レギンレイヴ = Reginleif
ゲイレルル = Geirölul
ローグ = Rogue
アサシン = Assassin
マスターアサシン = Master Assassin
ナイトアサシン = Night Assassin
エンフォーサー = Enforcer
プリンセス = Princess
ハイプリンセス = High Princess
ロイヤルハイネス = Royal Highness
マジェスティック = Majestic
ヴァンパイアプリンセス = Vampire Princess
イモータルプリンセス = Immortal Princess
ノスフェラトゥ = Nosferatu
ブラッドサッカー = Blood Sucker
ヴァンパイアクイーン = Vampire Queen
イモータルクイーン = Immortal Queen
イモータルオリジン = Immortal Origin
リビングエンド = Living End
ねんどろいどプリンセス = Nendoroid Princess
イビルプリンセス = Evil Princess
イビルクイーン = Evil Queen
イビルシーカー = Evil Seeker
デスブリンガー = Deathbringer
バンデット = Bandit
下級バンデット = Junior Bandit
バーサーカー = Berserker
デストロイヤー = Destroyer
フューリーブリガンド = Fury Brigand
オブリタレイター = Obliterator
竜戦士 = Dragon Warrior
下級竜兵 = Lesser Dragon Soldier
中級竜兵 = Intermediate Dragon Soldier
上級竜兵 = Advanced Dragon Soldier
超級竜兵 = Super Dragon Soldier
エンシェントドラゴン = Ancient Dragon
ファフニール = Fafnir
ドラゴンプリンセス = Dragon Princess
真竜戦士 = True Dragon Warrior
竜神戦士 = Dragon God Warrior
ドラゴンルーラー = Dragon Ruler
サムライ = Samurai
下級サムライ = Junior Samurai
サムライマスター = Samurai Master
ショーグン = Shogun
ダイショーグン = Dai Shogun
黒鋼大鎧武者 = Black Steel Armor Warrior
王子 = Prince
忍者 = Ninja
下級忍者 = Junior Ninja
忍者マスター = Ninja Master
超忍 = Ultimate Ninja
忍神 = Ninjin
ジライヤ = Jiraiya
ペガサスライダー = Pegasus Rider
ペガサスナイト = Pegasus Knight
ペガサスロード = Pegasus Lord
スカイキャバリア = Sky Cavalier
ペガサスマスター = Pegasus Master
ダークファイター = Dark Fighter
ダークナイト = Dark Knight
パラディン = Paladin
マスターパラディン = Master Paladin
カオスナイト = Chaos Knight
アベンジャー = Avenger
デスアベンジャー = Death Avenger
ヴェンデッタ = Vendetta
リヴェンジェンス = Revengeance
モンク = Monk
マスターモンク = Master Monk
拳聖 = Holy Fist
拳王 = King of Fighters
修羅 = Shura
前衛戦術家 = Vanguard Tactician
前衛軍師 = Vanguard Strategist
武人軍師 = Military Strategist
猛将軍師 = Brave Warrior-Tactician
大軍配者 = Great Military Strategist
魔法剣士 = Magic Fencer
ルーンフェンサー = Rune Fencer
ルーンロード = Rune Lord
ルーンデルヴァー = Rune Delver
ルーンスレイヤー = Rune Slayer
エンジェル = Angel
アークエンジェル = Arch Angel
ドミニオン = Dominion
セラフィム = Seraphim
アズライール = Azrael
くぐつ使い = Puppeteer
機甲士 = Machinist
超電機甲士 = Super Electric Machinist
ドールマスター = Doll Master
ライドマスター = Ride Master
セーラー = Sailor
セーラーチーフ = Sailor Chief
セーラーエリート = Sailor Elite
アドミラル = Admiral
ドレッドノート = Dreadnought
妖狐 = Youko
天狐 = Tenko
式鬼 = Shikioni
金剛式鬼 = Kongou Shikioni
神官戦士 = Priest Warrior
神官戦士長 = Priest Warrior Leader
ディバインアーマー = Divine Armor
ディバインロード = Divine Lord
ゴッドウォリアー = God Warrior
ソードスケルトン = Sword skeleton
スケルトンランサー = Skeleton Lancer
メイジアーマー = Mage Armor
バトルメイジ = Battle Mage
超魔導鎧将 = Super Magic Armor General
極魔導鎧帝 = Ultimate Magic Armor Sovereign
ミスティックシールド = Mystic shield
ドラゴンライダー = Dragon Rider
ドラゴンナイト = Dragon Knight
ドラゴンロード = Dragon Lord
ドラゴンマスター = Dragon Master
ドラゴンブリンガー = Dragon Bringer
ボウライダー = Bowrider
ボウライダーチーフ = Bowrider Chief
ボウライダーエリート = Bowrider Elite
ボウライダーマスター = Bowrider Master
ボウストームキャバリア = Bow Storm Cavalier
トラップ = Trap
強化トラップ = Strong trap
覚醒トラップ = Super-Strong trap
メイド = Maid
メイド長 = Maid Chief
バトルメイド = Battle Maid
アーマーメイド = Armor Maid
ヴァンパイアロード = Vampire Lord
ヴァンパイアハイロード = Vampire High Lord
カーミラ = Carmilla
デイウォーカー = Daywalker
ソードマスター = Swordmaster
剣聖 = Sword Saint
デッドリーエッジ = Deadly Edge
剣神 = Sword God
魔獣オルトロス = Hellbeast Orthros
魔獣ケルベロス = Hellbeast Cerberus
魔獣ケルベロス = Hellbeast Cerberus
魔獣ケルベロス = Hellbeast Cerberus
ロイヤルガード = Royal Guard
ロイヤルオーダー = Royal Order
ロードオブロイヤルズ = Lord of Royals
セイクリッドガード = Sacred Guard
リッチ = Lich
仙人 = Hermit
大仙人 = Great Hermit
魔神 = Majin
魔神王 = Majin King
マーセナリー = Mercenary
マスターマーセナリー = Master Mercenary
仙猿 = Monkey Sage
大仙猿 = Great Monkey Sage
ガーディアンゴーレム = Guardian Golem
プロトゴーレム = Protogolem
戦の聖霊 = Spirit of War
戦の大聖霊 = Great Spirit of War
ダークストーカー = Dark Stalker
アビスダークストーカー = Abyss Dark Stalker
ダークドミネイター = Dark Dominator
エクリプスストーカー = Eclipse Stalker
スチームタンク = Steam Tank
インプ = Imp
デーモン = Demon
ぬらりひょん = Nurarihyon
総大将ぬらりひょん = General Nurarihyon
妖怪剣客ぬらりひょん = Youkai Swordsman Nurarihyon
妖怪総元締ぬらりひょん = Youkai Supreme Commander Nurarihyon
重装砲兵 = Heavy Artillery
キャノンアーマー = Cannon Armor
ギガキャノンアーマー = Giga Cannon Armor
バスターアーマー = Buster Armor
フォートレス = Fortress
デシウス = Decius
ファイアエレメンタル = Fire Elemental
上級ファイアエレメンタル = Advanced Fire Elemental
鬼 = Oni
大鬼 = Great Oni
明王 = Myouou
鬼刃衆頭領 = Kibashuu Chief
インペリアルナイト = Imperial Knight
インペリアルオーダー = Imperial Order
ナイトオブナイツ = Knight of Knights
帝国筆頭騎士 = Imperial Cardinal Knight
インペリアルジェネラル = Imperial General
ケットシー = Cait Sith
天狗 = Tengu
大天狗 = Daitengu
空神 = Sky God
天魔天狗 = Tenma Tengu
霧分身 = Mist Clone
鍛冶職人 = Blacksmith
マスタースミス = Master Smith
神匠鍛冶師 = Divine Artisan Blacksmith
バトルスミス = Battlesmith
グラディエーター = Gladiator
次席剣闘士 = Associate Gladiator
筆頭剣闘士 = Chief Gladiator
オークブレイバー = Orc Braver
オンスロート = Onslaught
アースエレメンタル = Earth Elemental
上級アースエレメンタル = Advanced Earth Elemental
キョンシー = Jiangshi
屍道士 = Shikigami
エアーエレメンタル = Air Elemental
上級エアーエレメンタル = Advanced Air Elemental
ダークエレメンタル = Dark Elemental
上級ダークエレメンタル = Advanced Dark Elemental
大ガマ = Great Toad
雷公 = Raikou
雷神 = Raijin
タケミカヅチ = Takemikazuchi
雷鬼 = Raiki
モンスターブレイカー = Monster Breaker
モンスターパニッシャー = Monster Punisher
バリケード = Barricade
風伯 = Fuuhaku
風神 = Fuujin
シナツヒコ = Shinatsuhiko
風鬼 = Fuuki
ウォーターエレメンタル = Water Elemental
上級ウォーターエレメンタル = Advanced Water Elemental
王太子 = King Ogata
公子 = Koko
化け猫 = Bakeneko
ミミック = Mimic
グランドナイト = Grand Knight
ロードナイト = Lord Knight
デュークナイト = Duke Knight
ジャックランタン = Jack-o'-Lantern
砲撃ポイント = Bombardment point
グリフィンライダー = Griffin Rider
グリフィンナイト = Griffin Knight
鏡花水月 = Kyoka Suigetsu
サッパー = Sapper
サッパーチーフ = Sapper Chief
真人 = Zhenren
飛天真人 = Heavenly Zhenren
操屍人 = Corpse Marionette
帝国騎士 = Imperial Knight
邪仙 = Evil Hermit
大邪仙 = Great Evil Hermit
金光聖菩分身 = Jin-Guang Sheng-Pu Clone
金光聖菩分身覚醒 = AW Jin-Guang Sheng-Pu Clone
王子【獣装】 = Prince 【Beast】
皇帝 = Emperor
王子 = Prince
王子【神器装備】 = Prince 【Sacred Equipment】
王子【ケラウノス】 = Prince 【Keraunos】
王子【幼少】 = Prince 【Shota】
王子【砂漠】 = Prince 【Desert】
ランスマスター = Lance Master
槍聖 = Lance Saint
デーモンロード = Demon Lord
デーモンハイロード = Demon High Lord
犬神 = Inugami
料理人 = Chef
料理長 = Head Chef
デモンルーン = Demon Rune
デモンハイルーン = Demon High Rune
スチームナイト = Steam Knight
スチームガーディアン = Steam Guardian
バーバリアンクイーン = Barbarian Queen
かまいたち = Kamaitachi
疾風かまいたち = Gale Kamaitachi
シーソルジャー = Sea Soldier
下級シーソルジャー = Junior Sea Soldier
シーソルジャーチーフ = Sea Soldier Chief
アクアナイト = Aqua Knight
アビサルナイト = Abyssal Knight
古代魔導機兵 = Ancient Magic Machine Soldier
スカウト = Scout
スカウトオフィサー = Scout Officer
アーチャー = Archer
下級アーチャー = Junior Archer
スナイパー = Sniper
アルテミス = Artemis
セレーネ = Selene
ラピッドシューター = Rapid Shooter
メイジ = Mage
下級メイジ = Junior Mage
ウォーロック = Warlock
アークメイジ = Arch Mage
メイガスアデプト = Magus Adept
メイジデストラクト = Mage Destruct
ヒーラー = Healer
プリースト = Priest
セイント = Saint
ハイエロファント = Hierophant
オラクル = Oracle
ウィッチ = Witch
ロードウィッチ = Lord Witch
アークウィッチ = Arch Witch
ホーリーウィッチ = Holy witch
ソーサレス = Sorceress
パイレーツ = Pirate
下級パイレーツ = Junior Pirate
キャプテン = Captain
キングオブパイレーツ = King of Pirates
ネプチューン = Neptune
エル・ドラゴ = El Drago
ドラゴンシャーマン = Dragon Shaman
ドラゴンシャーマンロード = Dragon Shaman Lord
エルダードラゴンシャーマン = Elder Dragon Shaman
極神竜巫女 = Ultimate Dragon God Miko
ヴァンパイアハンター = Vampire Hunter
ヴァンパイアキラー = Vampire Killer
アンデッドキラー = Undead Killer
シャドウハンター = Shadow Hunter
ジャッジメント = Judgement
シャーマン = Shaman
ハイシャーマン = High Shaman
シャーマンロード = Shaman Lord
神託巫女 = Oracle Miko
ビジョナリー = Visionary
ビショップ = Bishop
ハイビショップ = High Bishop
エルダービショップ = Elder Bishop
パトリアーク = Patriarch
フィロソファー = Philosopher
後衛戦術家 = Rearguard Tactician
後衛軍師 = Rearguard Strategist
参謀軍師 = Staff Strategist
大参謀 = Great Adviser
バトルストラテジスト = Battle Strategist
陰陽師 = Onmyouji
陰陽頭 = Onmyou Chief
悟得陰陽頭 = Enlightened Onmyou Chief
召鬼陰陽頭 = Oni-Summoning Onmyou Chief
サモナー = Summoner
サモンマスター = Summon Master
グランドサモナー = Grand Summoner
幻想召喚士 = Phantasm Summoner
風水使い = Feng Shui User
風水士 = Feng Shui Master
風水導士 = Feng Shui Instructor
風水仙人 = Feng Shui Sage
八門風水導士 = 8-Gates Feng Shui Instructor
砲術士 = Gunner
重砲士 = Heavy Gunner
キャノンマスター = Cannon Master
ハイキャノンマスター = High Cannon Master
超重巨砲士 = Super-Heavy Gunner
ダンサー = Dancer
トップダンサー = Top Dancer
スーパーダンサー = Super Dancer
プリンシパル = Principal
グランアリエッタ = Grand Arietta
政務官 = Parliamentary Secretary
ネクロマンサー = Necromancer
ヘルネクロマンサー = Hell Necromancer
クロノウィッチ = Chrono Witch
アーククロノウィッチ = Arch Chrono Witch
クロノマスター = Chrono Master
クロノマンサー = Chronomancer
ドルイド = Druid
マスタードルイド = Master Druid
クイーンオブドルイド = Queen of Druid
フォレストクイーン = Forest Queen
生命の木 = Tree of Life
覚醒生命の木 = Sacred Tree of Life
覚醒生命の木第二A = Tree of Life AW2v1
覚醒生命の木第二B = Tree of Life AW2v2
アルケミスト = Alchemist
ハイアルケミスト = High Alchemist
マスターアルケミスト = Master Alchemist
ロードオブヘルメス = Lord of Hermes
マグヌムオプス = Magnum Opus
レンジャー = Ranger
ハイレンジャー = High Ranger
マスターレンジャー = Master Ranger
アークワーデン = Arch Warden
トラップマスター = Trap Master
シーフ = Thief
マスターシーフ = Master Thief
トレジャーハンター = Treasure Hunter
呪術使い = Curse User
呪術師 = Witch Doctor
大呪術師長 = Great Witch Doctor Chief
大呪術師祖 = Great Witch Doctor Progenitor
妖厄神 = Bewitching Yakujin
魔物使い = Beast Tamer
魔獣使い = Hellbeast Tamer
ビーストマスター = Beastmaster
魔獣調教師 = Hellbeast Trainer
ダークプリースト = Dark Priest
ダークハイプリースト = Dark High Priest
ダークカーディナル = Dark Cardinal
メトゥス = Metus
エンチャンター = Enchanter
ハイエンチャンター = High Enchanter
ゴーレムマスター = Golem Master
グランドエンチャンター = Grand Enchanter
マーチャント = Merchant
エルダーマーチャント = Elder Merchant
キャラバンマスター = Caravan Master
タイクーン = Tycoon
フェンリルシャーマン = Fenrir Shaman
フェンリルシャーマンロード = Fenrir Shaman Lord
フェンリルシャーマンロード = Fenrir Shaman Lord
避禍予見の鏡影 = Mirror of escape preview
モンスタースレイヤー = Monster Slayer
モンスターバスター = Monster Buster
ペネトレーター = Penetrator
ヘビートリガー = Heavy Trigger
プリズムミラー = Prism Mirror
第二覚醒プリズムミラー = AW2 Prism Mirror
デモンサモナー = Demon Summoner
デモンマスター = Demon Master
デモンルーラー = Demon Ruler
デモンブリンガー = Demon Bringer
エレメンタラー = Elementaler
エレメンタルマスター = Elemental Master
猫又 = Nekomata
猫ショウ = Nekoshou
道化師 = Jester
クラウンマスター = Clown Master
宮廷道化師 = Court Jester
ジョーカー = Joker
芸術家の逸品 = Artist's Masterpiece
聖樹 = Sacred tree
アコライト = Acolyte
ハイアコライト = High Acolyte
ルーンアコライト = Rune Acolyte
ホーリーアコライト = Holy Acolyte
ライフリンカー = Lifelinker
リンクマスター = Link Master
バリスタ = Ballista
重バリスタ = Heavy Ballista
幻獣使い = Phantasm Beast Tamer
大幻獣使い = Great Phantasm Beast Tamer
チェイスハンター = Chase Hunter
ロード = Lord
ハイロード = High Lord
モナーク = Monarch
支援工兵 = Support Engineer
エリートパイオニア = Elite Pioneer
妖狸 = Youri
大妖狸 = Great Youri
異界召喚士 = Ikai Summoner
イビルインヴォーカー = Evil Invoker
犬神 = Inugami
犬神頭 = Inugami Chief
新米刑事【流星WA】 = Novice Detective (RWA)
風の魔術師【流星WA】 = Wind Magician (RWA)
交通課職員【流星WA】 = Traffic Officer (RWA)
シービショップ = Sea Bishop
シーハイビショップ = Sea High Bishop
ロケットトルーパー = Rocket Trooper
ジェットトルーパー = Jet Trooper
ぬえ = Nue
大妖ぬえ = Great Nue
転生魔導士 = Reincarnation Mage
発明家 = Inventor
大発明家 = Great Inventor
スカイウォリアー = Sky Warrior
下級スカイウォリアー = Junior Sky Warrior
スカイウォリアーチーフ = Sky Warrior Chief
ドレッドウィング = Dread Wing
スカイシューター = Sky Shooter
下級スカイシューター = Junior Sky Shooter
スカイシューターチーフ = Sky Shooter Chief
アローウィング = Arrow Wing
ちびソルジャー = Chibi Soldier
ちびヘビーアーマー = Chibi Heavy Armor
ちびワルキューレ = Chibi Valkyrie
ちびローグ = Chibi Rogue
ちびプリンセス = Chibi Princess
ちびヴァンパイアプリンセス = Chibi Vampire Princess
ちびバンデット = Chibi Bandit
ちびサムライ = Chibi Samurai
ちび王子 = Chibi Prince
ちびペガサスライダー = Chibi Pegasus Rider
ちびダークファイター = Chibi Dark Fighter
ちびアベンジャー = Chibi Avenger
ちびモンク = Chibi Monk
ちび前衛戦術家 = Chibi Vanguard Tactician
ちび魔法剣士 = Chibi Magic Fencer
ちびエンジェル = Chibi Angel
ちびセーラー = Chibi Sailor
ちび妖狐 = Chibi Youko
ちびメイジアーマー = Chibi Mage Armor
ちびメイド = Chibi Maid
ちびロイヤルガード = Chibi Royal Guard
ちび仙人 = Chibi Hermit
ちび天狗 = Chibi Tengu
ちび大邪仙 = Chibi Evil Hermit
ちび金光聖菩分身 = Chibi Jin-Guang Sheng-Pu Clone
ちびアーチャー = Chibi Archer
ちびメイジ = Chibi Mage
ちびヒーラー = Chibi Healer
ちびウィッチ = Chibi Witch
ちびビショップ = Chibi Bishop
ちび後衛戦術家 = Chibi Rearguard Tactician
ちび陰陽師 = Chibi Onmyouji
ちびサモナー = Chibi Summoner
ちび風水使い = Chibi Feng Shui User
ちび砲術士 = Chibi Gunner
ちびパイレーツ = Chibi Pirate
ちびクロノウィッチ = Chibi Chrono Witch
ちびドルイド = Chibi Druid
ちびアルケミスト = Chibi Alchemist
ちび魔物使い = Chibi Beast Tamer
ちびダークプリースト = Chibi Dark Priest
ちびデモンマスター = Chibi Demon Master
鉄の聖霊 = Iron's Holy Spirit
銅の聖霊 = Copper holy spirit
銀の聖霊 = Silver Spirit
金の聖霊 = Golden Holy Spirit
白金の聖霊 = Holy Spirit of platinum
黒の聖霊 = Black Spirit
技強化の聖霊 = Holy Spirit of technical strengthening
換金ユニット = Cash unit
時の聖霊 = Holy Spirit of Time
経験値ユニット = Experience value unit
覚醒の聖霊 = Holy Spirit of awakening
聖霊女王 = Queen of the Holy Spirit
祝福の聖霊 = Blessed Holy Spirit
技覚醒の聖霊 = Holy Spirit of Technical Awakening
刻の聖霊 = Time of the Holy Spirit
光彩の聖霊 = Holy Spirit of the glow
小祝福の聖霊 = Small blessed Holy Spirit
絆の聖霊 = Holy Spirit of Ties
極金の聖霊 = Holy Spirit of the ultimate gold
極白金の聖霊 = Polar platinum's Holy Spirit
極黒の聖霊 = Dark black Holy Spirit
常闇の聖霊 = Holy Spirit of Chastity
技強化の大聖霊 = Great Holy Spirit of Technical Enhancement
育成の聖霊 = Holy Spirit of breeding
技強化ユニット = Technical enhancement unit
極星の聖霊女王 = Polar Queen of the Holy Spirit
小祝福の聖霊 = Small blessed Holy Spirit
経験値ユニット = Experience value unit